I	 Isoleucine 	Ile
would 	 Tryptophan 	Trp
very 	 Valine 	Val
much     Methionine  	Met
like 	 Leucine	Leu
getting  Glycine 	Gly
As	 Alanine 	Ala
Freaking Phenylalanine 	Phe 
Please	 Proline 	Pro

Santas	Serine 		Ser
Team	Threonine 	Thr
Crafts	Cysteine 	Cys
New	Asparagine 	Asn	
Quilts	Glutamine 	Gln
Yearly	Tyrosine 	Tyr

HongKong 	RED

Histidine 	His
Lysine 		Lys
Arginine 	Arg
Glutamic Acid	Glu
Asaprtic Acid   Asp